################################################################################
#                                                                              #
#                                                                              #
#                                                                              #
#               #                                                              #
#                              #                                               #
#                                                                              #
#                                                                              #
#                                                      #  #          #         #
#                                                                              #
#           #                                                                  #
#                                                                              #
#                                                                              #
#                                                                              #
#                                    #                                         #
# #                                                 #      #                   #
#          #                                                                   #
#                          #                                                   #
#                                                                              #
#                                                                              #
#                                                                              #
#                                        #                                     #
#                    #                                                         #
#                                                                              #
################################################################################
